1,1,1,1,1,1,1,1,1,1,1,19,19,19,0,0,0,0,2,2,2,5,2,2,2,2,2,4,2,2,2,2,0,0,0,0,19,19,19,1,1,1,1,1,1,1,1,1,1,1
1,18,1,1,1,1,1,1,1,1,19,19,19,19,0,0,0,0,2,2,4,2,2,2,2,5,2,2,2,2,2,2,0,0,0,0,19,19,19,19,1,1,17,1,1,1,1,1,1,1
1,1,1,1,1,1,1,1,1,1,19,20,19,0,0,0,0,0,2,2,24,27,27,27,27,30,30,30,30,33,2,4,0,0,0,0,0,19,20,19,1,1,1,1,1,1,16,1,1,1
1,1,1,1,1,1,15,1,1,1,19,19,19,0,0,0,0,0,5,2,25,28,28,28,28,31,31,31,31,34,2,2,0,0,0,0,0,19,19,19,1,1,1,1,1,1,1,1,1,1
1,1,1,1,1,1,1,1,1,1,19,19,19,0,0,0,0,0,2,2,26,29,29,29,29,32,32,32,32,35,2,2,0,0,0,0,0,19,19,19,1,1,17,1,1,1,1,1,1,1
1,1,1,1,1,1,1,1,1,19,19,19,19,0,0,0,0,0,2,2,2,2,2,2,2,2,2,2,2,2,2,2,0,0,0,0,0,19,19,19,1,1,1,1,1,1,1,1,17,1
1,15,1,1,1,1,1,1,19,20,19,19,0,0,0,0,0,0,0,2,2,5,2,2,2,2,2,2,4,2,2,0,0,0,0,0,0,0,19,19,20,19,1,1,16,1,1,1,1,1
1,1,1,1,1,1,1,19,19,19,19,0,0,0,23,0,0,0,0,0,2,2,2,2,4,2,2,5,2,2,0,0,0,0,0,23,0,0,0,19,19,19,19,1,1,1,1,1,1,1
1,1,1,1,1,18,9,11,11,11,11,10,0,0,0,0,0,0,0,0,0,0,0,0,0,0,0,0,0,21,0,0,0,0,0,0,0,0,10,11,11,11,11,9,1,1,1,1,1,1
1,1,1,1,1,1,6,8,8,8,8,7,0,0,0,0,0,0,0,0,21,0,0,0,0,0,0,0,0,0,0,0,0,0,0,0,0,0,7,8,8,8,8,6,1,1,1,1,1,1
1,1,1,1,1,1,6,8,8,8,8,7,0,0,0,0,0,0,0,0,0,0,0,0,0,0,0,0,0,0,0,0,22,0,0,0,0,0,7,8,8,8,8,6,1,1,1,1,1,1
1,1,1,1,1,1,6,8,8,8,8,7,0,0,0,22,0,0,0,0,0,0,0,0,0,0,0,21,0,0,0,0,0,0,0,0,0,0,7,8,8,8,8,6,1,1,1,1,1,1
1,1,1,1,1,1,6,8,8,8,8,7,0,0,0,0,0,0,0,0,0,21,0,0,0,0,0,0,0,0,0,0,0,0,0,0,0,0,7,8,8,8,8,6,1,1,1,1,1,1
1,1,1,1,1,1,12,14,14,14,14,13,0,0,0,0,0,0,3,3,49,50,50,50,50,50,50,50,50,51,3,3,0,0,0,0,0,0,12,14,14,14,14,12,1,1,1,1,1,1
1,1,1,1,1,1,1,1,19,19,19,19,23,0,0,0,0,0,46,3,3,45,45,45,3,3,45,45,45,3,3,46,0,0,0,0,0,23,19,19,19,19,1,1,1,1,1,1,1,1
1,1,1,1,1,1,1,1,19,19,20,19,0,0,0,0,0,0,47,3,3,3,3,3,3,3,3,3,3,3,3,47,0,0,22,0,0,0,19,20,19,19,1,1,1,1,1,1,1,1
1,1,1,1,1,1,1,1,1,19,19,19,19,0,0,0,0,0,47,3,3,3,3,3,3,3,3,3,3,3,3,47,0,0,0,0,0,19,19,19,19,1,1,1,1,1,1,18,1,1
1,1,1,1,16,1,1,1,1,1,19,19,19,19,0,0,22,0,48,36,3,3,3,3,3,3,3,3,3,3,37,48,0,0,0,0,19,19,19,19,1,1,1,1,1,1,1,1,1,1
1,1,1,1,1,1,1,17,1,1,1,19,19,19,0,0,0,0,3,3,3,3,3,40,43,43,38,3,3,3,3,3,0,0,0,0,19,19,19,1,1,15,1,1,1,1,1,1,1,1
1,1,17,1,1,1,1,1,1,1,1,19,19,19,0,0,0,0,3,3,3,3,3,43,3,3,43,3,3,3,3,3,0,0,0,0,19,19,19,1,1,1,1,1,1,1,1,1,1,1
1,1,1,1,1,1,1,1,1,1,1,19,19,19,0,0,0,0,46,3,3,3,3,3,3,3,3,3,3,3,3,46,0,0,0,0,19,20,19,1,1,1,1,1,1,1,1,1,1,1
1,1,1,1,16,1,1,1,1,1,1,19,20,19,0,0,0,0,47,3,3,3,3,41,42,41,42,3,3,3,3,47,0,0,0,0,19,19,19,1,1,1,1,1,1,1,1,1,1,1
1,1,1,1,1,1,1,1,17,1,1,19,19,19,0,0,0,0,47,3,3,3,3,3,3,3,3,3,3,3,3,47,0,0,0,0,19,19,19,1,1,1,18,1,1,1,1,1,15,1
1,1,1,1,1,1,1,1,1,1,1,19,19,19,19,0,0,0,47,39,39,39,3,3,3,3,3,3,44,44,44,47,0,0,0,19,19,19,19,1,1,1,1,1,1,1,1,1,1,1
1,1,1,1,1,1,1,1,1,1,1,1,19,19,19,19,0,0,47,39,39,39,3,3,3,3,3,3,44,44,44,47,0,0,19,19,19,19,1,1,1,1,1,1,1,1,1,1,1,1